07070707
00000000
00000000
00000000
00000000
00000000
00000000
40000000